***********************************************************
*     *    **           ****  ****             *        ***
*              *      ***        *             ** ***** ***
*   **** *     *            *    *    *                   *
**  *    *     **  **********  ***  ***        *          *
*   *     *           **               *       *          *
*    *      ***       **              ******     * **     *
*             *****        *   **  *  *            **     *
*    ******       *        *          *    **           ***
*   *****          ******  *           *           **  *  *
*             ***             *  *         ***  ***** *   *
* ****  ****           *      ****        **              *
*          *       *****        ******  ****         *    *        
*       *                        *         *******   ***  *
*  ******  *****   **    **      *                        *
*    *                         *** *******************    *
*    *    * ** ** *       **                              *
**** *** **  * ** ******  **   *************  ***  ****** *
*        *                                                *
***********************************************************